y=2, x=4, rocks=1
#######
#     #
#^  @ #
#   ' #
#     #
#######
